1111111
1010101
1021201
1010201
1121101
1010201
1020101
1010101
1111111