1111111111111
1010202020201
1020102021101
1020101020101
1111102120201
1020102020101
1111111111111