1111111111111
1010102010101
1121112021201
1010201010201
1020111110101
1020202010201
1111111111111