111111111
101020201
111011211
102020201
102020101
101010201
112120101
102020201
102121101
101010101
111111111