111111111
101020201
112011201
101010101
111120201
101010201
112111111
102020101
112010101
102010201
111111111