111111111
102010201
101021111
101010201
112010201
102020201
111111111