111111111
101020101
101120101
102020101
112110111
101020101
102120201
101010101
102021111
102010101
111111111