111111111
102010201
111020111
102010201
112011201
101010201
111111111