111111111
101010201
102021101
101020101
101121101
102020101
111111111