1111111111111
1010202010101
1111202010211
1010101020101
1010212111211
1020201020101
1121111121101
1020201010201
1111111111111