11111111111
10102020101
10101121201
10101020201
11112020111
10201020101
11111020201
10201020101
10111021101
10201020101
11101120201
10201020101
11111111111