111111111
101020101
102121211
102010101
112121201
101010101
101121211
101020201
112010211
101010201
111110211
101020101
111111111