1111111
1020101
1021211
1010101
1021101
1020101
1121211
1010201
1121111
1010201
1121111
1020101
1111111