11111111111
10102020201
10102110201
10202020201
10201120211
10202010201
11102110111
10201020101
10201011111
10101010101
11111111111