111111111
101020201
101020101
101020101
102020201
102010201
111111111