111111111
102020101
112110111
102010201
111121211
101020101
112020101
102020201
111111111