1111111
1020101
1011111
1020201
1111101
1010101
1020211
1010201
1111111