11111111111
10201010201
10102011101
10102010201
10212020101
10102020201
11111110211
10101020201
10212010111
10201020101
10201120201
10101010201
11111111111