111111111
102020101
101120111
102020201
112010211
101010101
111120201
102010101
112021111
102010201
102110201
102020201
111111111