1111111
1020101
1110101
1010101
1011111
1020101
1111111
1010201
1111111
1010201
1121201
1010201
1111111