1111111111111
1020201020201
1011111020111
1020201020101
1021211120101
1020201010101
1111201111211
1010102020101
1111111111111