111111111
102010201
112121111
102010101
112020201
102010101
111111111