11111111111
10202020101
11211010201
10202020201
10102121111
10201010101
11212120201
10202020201
11111111111