111111111
101010101
112021211
101010201
102111201
101010201
112110201
102010101
111111111