1111111
1020201
1110101
1020101
1120211
1010101
1021211
1020101
1111111