1111111
1020201
1120211
1010101
1111111
1020201
1111111