11111111111
10101010201
11112120101
10202010101
11201121111
10102010201
10202121101
10201010101
11101120101
10102010101
11112010201
10202010201
11111111111