111111111
101020101
112020211
102020101
111120101
101010101
101021111
101020101
111111111