1111111111111
1010102020101
1110212111211
1020102010101
1020112120111
1020201010201
1111102121201
1020101010201
1111111111111