1111111111111
1010201020101
1021212111201
1020101020201
1120211010101
1010102020101
1111111111111