1111111111111
1010102020101
1020111010101
1010101010201
1011111111101
1010102010101
1120111121101
1020102010201
1020202020101
1010201010201
1111111111111