1111111
1010201
1111101
1020101
1110201
1020201
1011201
1020201
1020201
1010101
1111111