1111111111111
1010101010101
1111111121101
1010101020101
1010112011211
1020101010101
1110111110201
1020102010101
1111102020201
1010201010101
1111111111111