1111111
1020201
1020211
1020201
1010201
1010201
1110201
1010201
1111111