11111111111
10102020201
11201110211
10101020101
11101010211
10102020101
11212020211
10202010101
10101020201
10201020101
11111111111