1111111
1010201
1121111
1020201
1120101
1020201
1011201
1010201
1111111