1111111111111
1020201010101
1010201111201
1010102020101
1011211011211
1010201020201
1011101110111
1020201010201
1111212011101
1020201020201
1020201020101
1010202010101
1111111111111