11111111111
10201010101
10102110111
10102020201
11111111111
10201010201
11211110211
10102020201
11111111111