1111111
1010201
1011101
1010201
1010111
1010201
1020111
1010101
1110201
1010101
1121211
1010201
1111111