11111111111
10102010201
10101110211
10201010101
10202121201
10101020201
11111111111