1111111111111
1020202020201
1110111110201
1010102010101
1021101010201
1010102010201
1111111111111