11111111111
10101020201
11212111211
10202020201
11201110201
10101020101
11111111111