11111111111
10102020101
11112010111
10101020201
11112110201
10202020101
11212111201
10102020101
10101121101
10101020101
11211110201
10101010101
11111111111