1111111111111
1020101010101
1111202121211
1020202010201
1111212011201
1020101020101
1111111111111